%%%%%%
%.   %
%    %
% %P %
%    %
%%%%%%
